2222232001072
220060162222
210220000002
210202221202
226202271104
220006000062
221022202222
221711171081
281000191021
201110121021
200700000011
222222222222