222222512111
2107000300191
222222220101
200006000701
181111111111
1010001010811
181818181811
100010001001
111111181101
200000002802
282222222022
200008000022