2102222122111
280008170002
222711110202
200000100202
532220101202
200806100202
220220116202
110270110202
100200000202
172202222202
192002006002
222222412222